NO xpm/east.xpm
SO xpm/south.xpm
WE xpm/west.xpm
EA xpm/east.xpm

F	1,40,0
C	0,230,255


	    1111111111111111111111111
	    1000000000110000000000001
	    1011000001110000000000001
	    1001000000000000000000001
111111111011000001110000111110001
100000000011000001110101111111111
11110111111111011100000010001
11110111111111011101010010001
1S000000110101011100000010001
10000000000000001100000010001
10000001110000011110100100001
11110111 1110101 101111010011
11111111 1111111 111111111111