EA      maps/map1.cub   
NO      maps/map1.cub   
SO       maps/map1.cub  
WE      maps/map1.cub
F       34234234
C        234234234
  



11111111111111111
11    1     1  11
11111111111111111